----------------------------------------------
-                                             -
-                x                            -
-               ---------                     -
-                                             -
-                                             -
-                                             -
-    \                                         -
-     \                                        -
-      \                                       -
-       \                                      -
-        \                                     -
-         \                                    -
-                 /                            -
-                /                             -
-               /                              -
-              /                               -
-             /                                -
-            /                                 -
-       \                                      -
-        \                                     -
-         \                                    -
-          \                                   -
-           \                                  -
-            \                                 -
-             \                                -
-              \                               -
-                                             -
-                  /                           -
-                 /                            -
-                /                             -
-               /                              -
-              /                               -
-             /                                -
-            /                                 -
-                                             -
-        \                                     -
-         \                                    -
-          \                                   -
-           \                                  -
-            \                                 -
-             \                                -
-              \                               -
-               \                              -
-                \                             -
-                 \                            -
-                                             -
-                                             -
-                                            --
-                                             -
-                                             -
-                                             -
-                                             -
-                                             -
-                                             -
-                                             -
-                                             -
-                                             -
-                                             -
-                                             -
-                                             -
----------------======------------------------
